1010101010
1010101010
1010101010
1111111110
0000000000
0000000000
1010101010
1010101010
1010101010
1111111111